11111111111111111111111111111
1000001010000000C10100010CC01
100P001000001C100100010000001
10000C00001111111111011111101
111C0010000000000100000000101
10000000000000000111110111101
10000000000E00000000000000101
10011111000000000111111111101
1001CC01000000000100C0C0C0001
1001C001000000000101010101001
100100010001110001C0000000001
10011011000110000101010101001
10000000000000000100C0C0C0001
10000001100000000111111111111
10000111111000000000000000001
1111111C111100000010000000001
10011110111000010010001100001
10000010100000010C10001C00001
11C10000000000010010000000001
1111100000000000000000000CC01
11111111111111111111111111111