11111111111111111111111111111111111111111111111
11111111111111111111111111111111111111111111111
11111111111111110000001111111111111111111111111
11111111111111000000000010011111111111111111111
111111111111100000C0000000001111111111111111111
11111111111110000000000000000111111111111111111
1111111111110001000000000P000111111111111111111
11111111111100000001100000001111111111111111111
11111111111110000011111001111111011111111111111
11111111111111000111111111111110000111111111111
11111111111110001111111111111111010011111111111
11111111111110000011111100011111000011111111111
1111111111110000000011100E000111100111111111111
11111111111001000000010000000011111111111111111
1111111111100C000000000000000011111111111111111
11111111111000C00000110000000011111111111111111
11111111111100000000000001000111111111011111111
11111111111111000000100C00001101111110001111111
11111111111111111000110000011111111111000111111
11111111111111111111111111111111111110001111111
11111111111111111111111111111111111111111111111