1111111111111111111
1111111111111111111
1111111000001111111
1111110000000011111
111110010000C001111
1111000000100101111
11110000P1110001111
11110C0010111011111
1111100001100011111
1111110C00000001111
111111100C0E0001111
1111111110000011111
1111111111111111111