11111111111111111111
11111111111111110111
11111111111111100011
11111110000001110011
111111000000C0011011
11111001100000C01111
111100C0001001001111
11110000P11100001111
11110000101110011111
11111000011000001111
11111100000000011111
11111100000000C00111
111111100C0E000C0111
11111111100000001111
11111111111111111111
11111111111111111111