1111111111111111111111111111111111111111
101000000001000C001100000000000111110111
1011100010011000001110011000100101111111
1010001110000011001100111001110111111111
1P0000001000000100000001100010000C0000E1
1111111111111111111111111111111111111111