1111111111111111111111111111111
1111111111111111111000111111111
1111000011111111110000011111111
11100C0000111111111001111111111
1111000000001111111111111111111
11110000E0000011111000011111111
1111100000000000000000001111111
11110000000011111000C0000111111
1111100C000111110C0100110111111
1111110000111110000001111111111
1111111111111111000000111111111
111111111111110000C010011111111
1111110001111110000001111111111
1111100000111111100011111111111
1111000000001111110111111111111
11110000C0000011110111111111111
1111100000000000000011111111111
11111100000P0000000000111111111
1111111000000001110000001111111
1111111100000000000000001111111
1111111111111111111111111111111