111111111111111111111
100010101010100000001
100C1010000000C000001
10C1010C00CCCCC0C0001
100C000C00000000000P1
1000C0C00000000011001
10001C000000000010001
100001100000001111111
100001010000100010001
100C01010000100E00001
100000000000100000001
10CC101CC00000C000001
1C00CCC00C00000000001
1C0000000C00000000001
10C00000C000000000001
100C000C0000000000011
1110C1100000001111111
100001010000000000011
100C01010000111100001
100001000000100100001
111111111111111111111