1111111111111111111
1111111111111111111
1111111000001111111
1111110000000011111
111110010000C001111
1111000000000001111
11110000P0000101111
1111000011100011111
1111100001000011111
1111110C00000001111
111111100C0E0001111
1111111110000011111
1111111111111111111